%%%%%%%%%
%%%%.%%%%
%%%% %%%%
%%%% %%%%
%.  P  .%
%%%% %%%%
%%%% %%%%
%%%%.%%%%
%%%%%%%%%
