%%%%%%%%%%%%%
%.          %
%G%%%%%%%%%P%
%.          %
%%%%%%%%%%%%%
