%%%%%%%%%%%%%
%..........o%
%.%%%% %%%%.%
%.%%G   %%%.%
%.%%%%%%%%%.%
%.....P.....%
%%%%%%%%%%%%%
