%%%%%%%%%%
%.......P%
%%%%%%%%%%
